4 4 4 4 4 4
4 3 0 4 5 4
4 4 0 4 0 4
0 4 0 0 1 4
0 4 2 0 0 4
0 4 4 4 4 4